00 00 00 00 99 99 99 99 99
00 00 00 99 99 00 00 00 99
00 00 99 99 00 11 12 00 99
00 99 99 00 00 00 00 00 21
99 99 00 00 00 00 00 00 99
99 00 00 00 13 00 00 00 99
99 00 00 00 00 00 00 00 99
99 00 00 00 00 00 00 00 99
99 99 22 99 99 23 99 99 99