00 00 99 99 99 99 00 00
00 00 99 11 00 99 00 00
99 99 99 00 00 99 99 99
99 00 00 00 00 00 00 21
24 00 00 00 00 12 00 99
99 00 00 00 00 00 00 99
99 00 00 00 00 00 00 99
22 00 00 00 00 14 00 99
99 00 00 00 00 00 00 99
99 99 99 00 00 99 99 99
00 00 99 00 00 99 00 00
00 00 99 99 99 99 00 00